10 15

L C C C C C L L C C C C L L L
L C H C H C C C C f f C L L L
L C C C C C L L C f f C L L L
L C S C L C C C C f f C L L L
L C C C L L C L C C C C L L L
L L L L L L C L L L L L L L L
L L L L C C C C L L L L L L L
L L L L C P P C L L L L L L L
L L L L C C C C L L L L L L L
L L L L L L L L L L L L L L L

male 1
female 1

BANKER 0
DRIVER 0
FARMER 1
SELLER 0
TEACHER 0
