30 50

F F F F F F F F F F F F F F F F F F F F F F F F F F F F F F F F F F F F F F F F F F F F F F F F F F
F F F F F F F F F F F W W W W R R R R R R R R R R R R R R R R R R R R R R R R R R R R R R R R R R F
F F F F F F F F F F F W W W L L L L f f f f f f f f f f f f f R R f f f f f f f f f f f f f F F F F
F F F F F F F F W W W W W W W L L L f f f f f f f f f f f f f R R f f f f f f f f f f f f f F F F F
F F F F F F F F F W W W W W L L L L f f f f f f f f f f f f f R R f f f f f f f f f f f f f F F F F
F F F F F F L L L L W W L L L L L L f f f f f f f f f f f f f R R f f f f f f f f f f f f f F F F F
F F F F R R R R R R R R R R R R R R R R R R R R R R R R R R R R R R R R R R R R R R R R R R R R R F
F F R R R R R R R R R R R R R R R R R R R R R R R R R R R R R R R R R R R R R R R R R R R R R R R F
F R R C C C S R R H H H H H H H H R R H H H H H H H H H R L L L L L L L L S R R L L L L L L L R R F
F R R C C C L R R R R R R R R R R R R R R R R R R R R R R L L L L L L L L L R R L L L L L L L R R F
F R R C C C L R R H H H H H H H H R R H H H H H H H H H R R R R R R R L L L R R L L L L L L L R R F
F R R C C C L R R R R R R R R R R R R R R R R R R R R R R P P P P P R R L L R R L L L L L L L R R F
F R R C C C L L L R S R R L L F F F F F F F R R R R R P P P P P P P R R R R R R L L L L L L L R R F
F R R C C C L L L R S R R L F F F F F W W F F R H H H R R P P P P P R R L L R R L L L L L L L R R F
F R R C C C L L L R S R R L L F F F F F W F R R H H H H H H H H H H H H H H R R L L L L L L L R R F
F R R C C C L L L R S R R R R R R H H H H H H H H H R R R R R R R R R S R R R R L L L L L L L R R F
F R R C C C L L L R R R R R R R R H H H H H R R H H H H H H R L L L L L L R R L L L L L L L L R R F
F R R L L L L L L L L L L P P P P P L L L L R R R R R R R R R R L L L L L L R R L L L L L L L R R F
F R R L L L L L L L L L P P P P P P P R R R R R S R R H H H H R C C C C C C C C C C C C C C W R R F
F R R L L L L L L L L L L P P P P P C C C C C C R R R R R R R R R R R R R R C C C C C W W W W R R F
F R R L L L L L L L L L L L R R L L L C C C C C C C C C C C C C C C R R S R C C C W W W W W W R R F
F R R L L L L L L L L L L L R R L L L C C C C C C C C C C C C C C C R R C C C W W W W W W W W R R F
F R R R R R R R R R R R R R R R R R R R R R R R R R R R R R R R R R R R R R R R R R R R R R R R R F
F R R R R R R R R R R R R R R R R R R R R R R R R R R R R R R R R R R R R R R R R R R R R R R R R F
F R R f f f f f f f f f f f f f f f f f f f f R R f f f f f f f f f f f f f f f f f f f f f f R R F
F R R f f f f f f f f f f f f f f f f f f f f R R f f f f f f f f f f f f f f f f f f f f f f R R F
F R R f f f f f f f f f f f f f f f f f f f f R R f f f f f f f f f f f f f f f f f f f f f f R R F
F R R f f f f f f f f f f f f f f f f f f f f R R f f f f f f f f f f f f f f f f f f f f f f R R F
F R R R R R R R R R R R R R R R R R R R R R R R R R R R R R R R R R R R R R R R R R R R R R R R R F
F F F F F F F F F F F F F F F F F F F F F F F F F F F F F F F F F F F F F F F F F F F F F F F F F F

male 10
female 10

BANKER 0.1
DRIVER 0.1
FARMER 0.3
SELLER 0.2
STUDENT 0.2
TEACHER 0.1
