25 39

F F F F F F F F F F F F F F F F F F F F F F F F F F F F F F F F F F F F F F
F F F F F F W W W L L L L f f f f f f f f f f f C C f f f f f f f f F F F F
F F F L L L L W W L L L L f f f f f f f f f f f C C f f f f f f f f F F F F
F F C C C C C C C C C C C C C C C C C C C C C C C C C C C C C C C C C C C F
F F C C C C C C C C C C C C C C C C C C C C C C C C C C C C C C C C C C C F
F C C S C C H H H H H H C H H H H H H H H C L L L L C C L L L L L L L C C F
F C C L C C C C C C C C C C C C C C C C C C L L L L C C L L L L L L L C C F
F C C L C C H H H H H H C H H H H H H H H C C C C C C C L L L L L L L C C F
F C C L C C C C C C C C C C C C C C C C C C P P P P C C L L L L L L L C C F
F C C L L L C S C L F F F F F C C C C C P P P P P P C C L L L L L L L C C F
F C C L L L C S C F F F F W F F C H H H C C P P P P C C L L L L L L L C C F
F C C L L L C S C L F F F W F C C H H H H H H H H H C C L L L L L L L C C F
F C C L L L C S C C C C H H H H H H H C C C C C C C C C L L L L L L L C C F
F C C L L L C C C C C C H H H C C H H H H H H C L L C L L L L L L L L C C F
F C L L L L L L L P P P P L L C C C C C C C C C C L C C L L L L L L L C C F
F C L L L L L L L P P P P C C C C S C C H H H H C C C C C C C C C C W C C F
F C L L L L L L L P P P P C C C C C C C C C C C C C C C C C C W W W W C C F
F C L L L L L L L C C L L C C C C C C C C C C C C C C C C W W W W W W C C F
F C L L L L L L L C C L L C C C C C C C C C C C C C C W W W W W W W W C C F
F C C C C C C C C C C C C C C C C C C C C C C C C C C C C C C C C C C C C F
F C C C C C C C C C C C C C C C C C C C C C C C C C C C C C C C C C C C C F
F C f f f f f f f f f f f f f f C C f f f f f f f f f f f f f f f f f C C F
F C f f f f f f f f f f f f f f C C f f f f f f f f f f f f f f f f f C C F
F C C C C C C C C C C C C C C C C C C C C C C C C C C C C C C C C C C C C F
F F F F F F F F F F F F F F F F F F F F F F F F F F F F F F F F F F F F F F

male 3
female 3

BANKER 0.2
DRIVER 0.0
FARMER 0.3
SELLER 0.3
TEACHER 0.2
